11111111111111111111
10000100000000000001
10000100000000100001
10000100000000000001
10000100000000000001
10000001000000000001
10000000000000000001
10000001000000000001
10000000000000000001
10000001000000000001
10000001101010100001
10000000000000000001
11111111111111111111
